11111111111111111
10000000000000001
10000000100000001
10000001010000001
10000010001000001
10000001010000001
10000000100000001
11111111111111111