11111111111111111
10000000000000001
1000C000100000001
100P0001010000001
100C0010001000001
100000010100C0001
100000001000000E1
11111111111111111