11111111111111110
10000000000000001
1000C000100000001
100P0001010001111
100C0010001000001
100100010100C0001
10CCC0001000000E1
11111111111111111