11111111111111111
10000000000000001
1000C000100000001
100P0001010001111
100C0010001000001
1001000101000E001
10CCC00E000001001
11111111111111111