111111111111111111111111111111111111
10P011111100C1000C111111011111111111
11101111111100011011110000C111111111
11100110000111011000C101110111111111
11110000110000011111000111000C000E11
111111111111111111111111111111111111