111111111111111111111111111111111111
10P011111100010000111111011111111111
111011111111000110111100000111111111
11100110C001110110000101110111111111
1111E00011Z0000111110001110000000011
111111111111111111111111111111111111